///--/////////
//[1@>-------/
//[@   @   @ ]
//[ ,/ , /  ,]
//[  , @  /  ]
/-< @/ /  // ]
[*@, , @  // ]
[ // @ /@/ t ]
[        ,s@p]
/////  ///////
//[      ]////
//[      ]////
//[@@//, ]////
//[,,//,,]////
//[,,F@  ]////
///______/////