///------/////
//[,,@,,,>////
//[@@@@,,,>-//
//[*  @,,,,,]/
//[@@  @,,,,]/
//[,,@  @,,,]/
//[,,,@  @,,]/
//[,,,@  @,,]/
//[,,,@  @,,]/
//[,,,,@F@,,]/
///_________//